VVVVVVMMMMMMMVVVVVVV
VVVVVVMMMMMMMVVVVVVV
MMMMMMMMVVMMMMMMMMMM
MMMMMMMMVVMMMMMMMMMM
MVVVVVVVVVVVVVVVVVVM
MVVVVVVVVVVVVVVVVVVM
MVVVVVVVVVVVMMMMMMMM
MMMMMMMMMMVVMMMMMMMM
MMMMMMMMMMVVMMMVVVVV
VVVVVVVMMMMMMMMVVVVV
