VVVVMMMMMVVVV
VVVVMMVMMVVVV
VVVVMMVMMMMMM
MMMMMMVVVVVVM
MVVVVVVVMMMMM
MMMMMMMVMVVVV
VVVVVVMVMVVVV
VVVVVVMMMVVVV
