VVVVVVMMMMMMMVVVVVVV
VVVVVVMMMMMMMVVVVVVV
MMMMMMMMVVMMMMMMMMMM
MMMMMMMMVVMMMMMMMMMM
MVVVVVVVVVVVVVVVVVVM
MVVVVVVVVGGVVVVVVVVM
MVVVVVVVVVVVMMMMMMMM
MMMMMMMMMMVVMMMMMMMM
MMMMMMMMMMVCMMMVVVVV
VVVVVVVMMMMMMMMVVVVV
